**********t********
*******************
****************i**
***f*****f*********
*********c*********
********c**********
*******c***********